#############
#   ##    # #
   @   ##   #
     ##   ###
#       #   #
####### ##  #
  #   ##### #
#   #       #
#############